###############B#####
### ##########  #####
##                  #
############ ########
#  #####     ##     #
#A               ## #
################### #
################### #
#                   #
# ################# #
# ########## ###### #
#          #        #
#### ########## #####
#     ######### #####
# ### ######### #####
# ### ######### #####
#   # #####     #####
# ### #########     #
# ### ######### #####
#                   #
#####################